1111111111111
10010000001C1
1C0001111C101
1P0011E000001
1111111111111
