11111111111111
1C0000000001C1
11011T11X00101
1P01C01E00T001
11111111111111
