111111111111111
1P10001110001R1
10000T010T00001
100010C1L010001
11T111111111T11
1000T01110T0001
1C00100E00100L1
111111111111111
