111111111111111
1P0001C100T00R1
1100T001L100011
10T0X101110XT11
1010111100010L1
1C10000E0101001
111111111111111
